Room No,Houskeeping,Food Order,Other Service
101,Null,Null,Null
102,Karthick,Null,Null
103,Null,Null,Null
104,Null,Null,Null
105,Null,Manoj,Null
106,Null,Null,Null
201,Null,Null,Null
202,Null,Null,Null
203,Null,Null,Devi
204,Null,Null,Null
205,Null,Null,Null
206,Null,Null,Null
301,Null,Null,Null
302,Null,Null,Null
303,Null,Null,Null
304,Null,Null,Null
305,Null,Null,Null
306,Null,Null,Null
